9 2 3 -1 
2 0 -1 0 
10 4 6 2 
9 2 3 -1 
2 0 -1 0 
10 4 6 2 
